NO
SO
WE
EA

C 200,230,255
F 80,60,30

111111111111
100000000001
10000N000001
100000000001
111111111111